00000000000000000
01111111111111110
01111111101111110
01111111111111110
01111101111111110
01111111111111110
01111101111111110
01111111111111110
01111111111111110
00000000000000000
