00000001110000000
01111111111111110
01111111100011110
01111111111111110
11111111111101110
11111111111101110
01111111111101110
01111111111111110
01111111111111110
00000000000000000
