00000000000000000
01110111111111110
01110111100011110
01100111111111110
01111111111111110
01111111111111110
01111111111111110
01111111111111110
01111111111111110
00000001110000000
